Shy /ʃaɪ/ nhút nhát
Confident	/ˈkɒn.fɪ.dənt/	tự tin
Original	/əˈrɪdʒ.ən.əl/	nguyên bản
Scared	/skeəd/	sợ hãi
Popular	/ˈpɒp.jə.lər/	thịnh hành
Absent	/ˈæb.sənt/	vắng mặt
Nervous	/ˈnɜː.vəs/	lo lắng
Special	/ˈspeʃ.əl/	đặc biệt
Favourite	/ˈfeɪ.vər.ɪt/	yêu thích
Crowded	/ˈkraʊ.dɪd/	đông đúc
Peaceful	/ˈpiːs.fəl/	bình yên
Beautiful	/ˈbjuː.tɪ.fəl/	đẹp
Common	/ˈkɒm.ən/	phổ biến
Acceptable	/əkˈsept.ə.bəl/	chấp nhận được
Punctual	/ˈpʌŋk.tʃu.əl/	đúng giờ
Challenging	/´tʃælindʒiη/	mang tính thách thức
Jobless	/ˈdʒɒb.ləs/	thất nghiệp
Qualified	/ˈkwɒl.ɪ.faɪd/	đủ khả năng
Employed	/ɪmˈplɔɪd/	có việc làm
Rich	/rɪtʃ/	giàu
Cheap	/tʃiːp/	rẻ
Expensive	/ɪkˈspen.sɪv/	đắt
Wasteful	/ˈweɪst.fəl/	phí phạm
Broke	/brəʊk/	cháy túi
Due	/dʒuː/	đến hạn
Reasonable	/ˈriː.zən.ə.bəl/	phải chăng
Generous	/ˈdʒen.ər.əs/	hào phóng
Exciting	/ɪkˈsaɪ.tɪŋ/	gây hứng thú
Lively	/ˈlaɪv.li/	sống động
Modern	/ˈmɒd.ən/	hiện đại
Various	/ˈveə.ri.əs/	đa dạng
Bustling	/ˈbʌs.lɪŋ/	náo nhiệt
Appealing	/əˈpiː.lɪŋ/	thu hút
Central	/ˈsen.trəl/	ở giữa
Convenient	/kənˈviː.ni.ənt/	tiện lợi
Pricey	/ˈpraɪ.si/	đắt đỏ
Selfish	/ˈsel.fɪʃ/	ích kỉ
Unhealthy	/ʌnˈhel.θi/	không tốt cho sức khoẻ
Poor	/pɔːr/	nghèo
Affordable	/əˈfɔː.də.bəl/	vừa túi tiền
Overpopulated	/ˌəʊ.vəˈpɒp.jə.leɪ.tɪd/	quá tải dân số
Comfortable	/ˈkʌm.fə.tə.bəl/	thoải mái
Cramped	/kræmpt/	chật chội
Safe	/seɪf/	an toàn
Vibrant	/ˈvaɪ.brənt/	sôi động
Friendly	/ˈfrend.li/	thân thiện
One-way	/ˌwʌnˈweɪ/	một chiều
Complicated	/ˈkɒm.plɪ.keɪ.tɪd/	phức tạp
Chilled	/tʃɪld/	thư giãn
Noisy	/ˈnɔɪ.zi/	ồn ào
Comfy	/ˈkʌm.fi/	dễ chịu
Cosy	/ˈkəʊ.zi/	ấm cúng
Excited	/ɪkˈsaɪ.tɪd/	hào hứng
Huge	/hjuːdʒ/	rất lớn
Amazing	/əˈmeɪ.zɪŋ/	đáng kinh ngạc
Disappointed	/ˌdɪs.əˈpɔɪn.tɪd/	thất vọng
Hidden	/ˈhɪd.ən/	bị ẩn giấu
Touristy	/ˈtʊə.rɪ.sti/	quá đông du khách
Lovely	/ˈlʌv.li/	đáng yêu
Local	/ˈləʊ.kəl/	thuộc địa phương
National	/ˈnæʃ.ən.əl/	toàn quốc
Normal	/ˈnɔː.məl/	bình thường
Fair	/feər/	công bằng
Strange	/streɪndʒ/	kì lạ
Angry	/ˈæŋ.ɡri/	tức giận
Proud	/praʊd/	tự hào
Traditional	/trəˈdɪʃ.ən.əl/	truyền thống
Familiar	/fəˈmɪl.i.ər/	quen thuộc
Rainy	/ˈreɪ.ni/	nhiều mưa
Pleasant	/ˈplez.ənt/	dễ chịu
Sunny	/ˈsʌn.i/	nhiều nắng
Nasty	/ˈnɑː.sti/	gây khó chịu
Awful	/ˈɔː.fəl/	kinh khủng
Typical	/ˈtɪp.ɪ.kəl/	điển hình
Humid	/ˈhjuː.mɪd/	ẩm
Yummy	/ˈjʌm.i/	ngon
Crispy	/ˈkrɪs.pi/	giòn
Sweet	/swiːt/	ngọt
Savoury	/ˈseɪ.vər.i/	có vị mặn
Vegetarian	/ˌvedʒ.ɪˈteə.ri.ən/	chay
Oily	/ˈɔɪ.li/	nhiều dầu mỡ
Dry	/draɪ/	khô
Hangry	/ˈhæŋ.ɡri/	cáu vì đói
Spicy	/ˈspaɪ.si/	cay
Thirsty	/ˈθɜː.sti/	khát nước
Tipsy	/ˈtɪp.si/	ngà ngà say
Useless	/ˈjuːs.ləs/	vô dụng
Sparkling	/ˈspɑː.klɪŋ/	có ga
Terrible	/ˈter.ə.bəl/	tồi tệ
Plain	/pleɪn/	nhạt
Strong	/strɒŋ/	nồng nàn; mạnh mẽ
Raw	/rɔː/	sống (chưa chín)
Fresh	/freʃ/	tươi
Delicious	/dɪˈlɪʃ.əs/	ngon miệng
Frozen	/ˈfrəʊ.zən/	đông lạnh
Undercooked	/ˌʌn.dəˈkʊkt/	chưa nấu kĩ
Tasty	/ˈteɪ.sti/	ngon
Strict	/strɪkt/	nghiêm ngặt
Crappy	/ˈkræp.i/	dở tệ
Ageing	/ˈeɪ.dʒɪŋ/	lão hóa
Abroad	/əˈbrɔːd/	ở nước ngoài
Daily	/ˈdeɪ.li/	hằng ngày
Beautifully	/’bju:təfuli/	một cách đẹp đẽ
Fully	/ˈfʊl.i/	hoàn toàn
Away	/əˈweɪ/	cách đây (bao xa)
Always	/ˈɔːl.weɪz/	luôn luôn
Mostly	/ˈməʊst.li/	hầu như
Everywhere	/ˈev.ri.weər/	khắp mọi nơi
Nowadays	/ˈnaʊ.ə.deɪz/	ngày nay
Generally	/ˈdʒen.ə r.əl.i/	nhìn chung thì
Leisurely	/ˈleʒ.ə.li/	một cách thong thả
Hardly	/ˈhɑːd.li/	hầu như không
Obviously	/ˈɒb.vi.əs.li/	hiển nhiên
Seriously	/ˈsɪə.ri.əs.li/	một cách nghiêm trọng
Slowly	/ˈsləʊ.li/	một cách từ từ
Quite	/kwaɪt/	hoàn toàn
Through	/θruː/	xuyên suốt
Quickly	/ˈkwɪk.li/	nhanh chóng
Carefully	/ˈkeə.fəl.i/	một cách cẩn thận
Safely	/ˈseɪf.li/	một cách an toàn
Regularly	/ˈreɡjələli/	một cách đều đặn
Quietly	/ˈkwaɪət.li/	một cách khẽ khàng
Frequently	/ˈfriː.kwənt.li/	một cách thường xuyên
Personally	/ˈpɜː.sən.əl.i/	về mặt cá nhân
Socially	/ˈsəʊ.ʃəl.i/	mang tính xã hội
Extremely	/ɪkˈstriːm.li/	cực kì
Totally	/ˈtəʊ.təl.i/	một cách hoàn toàn
Politely	/pəˈlaɪt.li/	một cách lịch sự
Especially	/ɪˈspeʃ.əl.i/	đặc biệt là
Particularly	/pəˈtɪk.jə.lə.li/	đặc biệt là
Wholesale	/ˈhəʊl.seɪl/	sỉ
Well	/wel/	(một cách) tốt
Perfectly	/ˈpɜː.fekt.li/	một cách hoàn hảo
Weekly	/ˈwiː.kli/	hàng tuần
Abroad	/əˈbrɔːd/	ở nước ngoài
Percent	/pəˈsent/	phần trăm
usually	/ˈjuːʒʊəli/	thường xuyên
often	/ˈɒf(ə)n/	thường
sometimes	/ˈsʌmtaɪmz/	thỉnh thoảng
occasionally	/əˈkeɪʒnəli/	đôi khi
seldom	/ˈsɛldəm/	hiếm khi
hardly ever	/ˈhɑːdli ˈɛvə/	hầu như không
already	/ɔːlˈrɛdi/	đã rồi
lately	/ˈleɪtli/	gần đây
still	/stɪl/	vẫn
tomorrow	/təˈmɒrəʊ/	ngày mai
early	/ˈɜːli/	sớm
now	/naʊ/	ngay bây giờ
soon	/suːn/	sớm thôi
yesterday	/ˈjɛstədeɪ/	hôm qua
finally	/ˈfaɪnəli/	cuối cùng thì
recently	/ˈriːsntli/	gần đây
besides	/bɪˈsaɪdz/	bên cạnh đó
then	/ðɛn/	sau đó
instead	/ɪnˈstɛd/	thay vào đó
moreover	/mɔːˈrəʊvə/	hơn nữa
as a result	/æz ə rɪˈzʌlt/	kết quả là
unlike	/ʌnˈlaɪk/	không giống như
furthermore	/ˈfɜːðəˈmɔː/	hơn nữa
on the other hand	/ɒn ði ˈʌðə hænd/	mặt khác
in fact	/ɪn fækt/	trên thực tế
here	/hɪə/	ở đây
there	/ðeə/	ở kia
somewhere	/ˈsʌmweə/	một nơi nào đó
anywhere	/ˈɛnɪweə/	bất kỳ đâu
nowhere	/ˈnəʊweə/	không ở đâu cả
nearby	/ˈnɪəbaɪ/	gần đây
slightly	/ˈslaɪtli/	một chút
perfectly	/ˈpɜːfɪktli/	hoàn hảo
pretty	/ˈprɪti/	khá là
almost	/ˈɔːlməʊst/	gần như
enormously	/ɪˈnɔːməsli/	cực kì
highly	/ˈhaɪli/	hết sức
angrily	/ˈæŋgrɪli/	một cách tức giận
simply	/ˈsɪmpli/	đơn giản
strongly	/ˈstrɒŋli/	cực kì
absolutely	/ˈæbsəluːtli/	tuyệt đối
rather	/ˈrɑːðə/	khá là
little	/ˈlɪtl/	một ít
entirely	/ɪnˈtaɪəli/	toàn bộ
remarkably	/rɪˈmɑːkəbli/	đáng kể
lazily	/ˈleɪzɪli/	một cách lười biếng
loudly	/ˈlaʊdli/	một cách ồn áo
carelessly	/ˈkeəlɪsli/	một cách cẩu thả
recklessly	/ˈrɛklɪsli/	một cách bất cẩn
easily	/ˈiːzɪli/	một cách dễ dàng
politely	/pəˈlaɪtli/	một cách lịch sự
accurately	/ˈækjʊrɪtli/	một cách chính xác
happily	/ˈhæpɪli/	một cách vui vẻ
hungrily	/ˈhʌŋgrɪli/	một cách đói khát
bravely	/ˈbreɪvli/	một cách dũng cảm
greedily	/ˈgriːdɪli/	một cách tham lam
mainly	/ˈmeɪnli/	chủ yếu là
expertly	/ˈɛkspɜːtli/	một cách điêu luyện
particularly	/pəˈtɪkjʊləli/	cụ thể là
professionally	/prəˈfɛʃnəli/	một cách chuyên nghiệp
anxiousl	/ˈæŋkʃəsli/	một cách lo âu
largely	/ˈlɑːʤli/	phần lớn là
cautiously	/ˈkɔːʃəsli/	một cách cần trọng
specifically	/spəˈsɪfɪk(ə)li/	cụ thể là
time /taɪm/ thời gian
year /jɪr/ năm
people /ˈpipəl/ con người
way /weɪ/ con đường
day /deɪ/ ngày
man /mən/ đàn ông
thing /θɪŋ/ sự vật
woman /ˈwʊmən/ phụ nữ
life /laɪf/ cuộc sống
child /ʧaɪld/ con cái
world /wɜrld/ thế giới
school /skul/ trường học
state /steɪt/ trạng thái
family /ˈfæməli/ gia đình
student /ˈstudənt/ học sinh
group /grup/ nhóm
country /ˈkʌntri/ đất nước
problem /ˈprɑbləm/ vấn đề
hand /hænd/ bàn tay
part /pɑrt/ bộ phận
place /pleɪs/ vị trí
case /keɪs/ trường hợp
week /wik/ tuần
company /'kʌmpəni/ công ty
system /ˈsɪstəm/ hệ thống
program /ˈproʊˌgræ m/chương trình
question /ˈkwɛsʧən/ câu hỏi
work /wɜrk/ công việc
government /ˈgʌvərmənt/ chính phủ
number /ˈnʌmbər/ con số
night /naɪt/ ban đêm
point /pɔɪnt/ điểm
home /hoʊm/ nhà
water /ˈwɔtər/ nước 
room /rum/ căn phòng
mother /'mʌðər/ mẹ
area /ˈɛriə/ khu vực
money /ˈmʌni/ tiền bạc
story /ˈstɔri/ câu chuyện
fact /fækt/ sự thật
month /mʌnθ/ tháng
lot /lɑt/ từng phần
right /raɪt/ quyền lợi
study /ˈstʌdi/ học tập
book /bʊk/ cuốn sách
eye /aɪ/ mắt
job /ʤɑb/ nghề nghiệp
word /wɜrd/ từ
business /ˈbɪznəs/ kinh doanh
issue /ˈɪʃu/ vấn đề
side /saɪd/ khía cạnh
kind /kaɪnd/ loại
head /hɛd/ đầu
house /haʊs/ ngôi nhà
service /ˈsɜrvəs/ dịch vụ
friend /frɛnd/ người bạn
father /ˈfɑðər/ cha
power /ˈpaʊər/ năng lượng
hour /ˈaʊər/ giờ 
game /geɪm/ trò chơi
line /laɪn/ vạch kẻ
end /ɛnd/ kết thúc
member /ˈmɛmbər/ thành viên
law /lɔ/ luật pháp
car /kɑr/ xe hơi
city /ˈsɪti/ thành phố
community /kəmˈjunəti/ cộng đồng
name /neɪm/ tên gọi
president /ˈprɛzəˌdɛnt/ chủ tịch
team /tim/ nhóm, đội
minute /ˈmɪnət/ phút
idea /aɪˈdiə/ ý tưởng
kid /kɪd/ trẻ con
body /ˈbɑdi/ cơ thể
information /ˌɪnfərˈmeɪʃən/ thông tin
back /bæk/ phía sau
parent /ˈpɛrənt/ phụ huynh
face /feɪs/ gương mặt
others /ˈʌðərz/ những cái khác
level /ˈlɛvəl/ cấp bậc
office /ˈɔfəs/ văn phòng
door /dɔr/ cánh cửa
health /hɛlθ/ sức khỏe
person /ˈpɜrsən/ con người
art /ɑrt/ nghệ thuật
war /wɔr/ chiến tranh
history /ˈhɪstəri/ lịch sử
party /ˈpɑrti/ bữa tiệc
result /rɪˈzʌlt/ kết quả
change /ʧeɪnʤ/ thay đổi
morning /ˈmɔrnɪŋ/ buổi sáng
reason /ˈrizən/ lý do
research /riˈsɜrʧ/ nghiên cứu
girl /gɜrl/ cô gái
guy /gaɪ/ chàng trai
moment /ˈmoʊmənt/ hiện tại
air /ɛr/ không khí
teacher /tiʧər/ giáo viên
force /fɔrs/ lực lượng
education /ɛʤəˈkeɪʃən/ giáo dục
Follow	/ˈfɒl.əʊ/	theo đuổi
Understand	/�n.dəˈstænd/	hiểu
Improve	/ɪmˈpruːv/	cải thiện
Communicate	/kəˈmjuː.nɪ.keɪt/	giao tiếp
Attend	/əˈtend/	tham dự
Continue	/kənˈtɪn.juː/	tiếp tục
Announce	/əˈnaʊns/	thông báo
Revise	/rɪˈvaɪz/	ôn tập
Enroll	/ɪnˈrəʊl/	nhập học
Succeed	/səkˈsiːd/	thành công
Memorise	/ˈmem.ə.raɪz/	học thuộc
Call	/kɔːl/	gọi (ai, là gì)
Know	/nəʊ/	biết
Tell	/tel/	kể (cho ai)
Spell	/spel/	đánh vần
Live	/lɪv/	sinh sống
Describe	/dɪˈskraɪb/	miêu tả
Sign	/saɪn/	kí tên
Open	/ˈəʊ.pən/	mở (một dịch vụ)
Offer	/ˈɒf.ər/	đề xuất
Design	/dɪˈzaɪn/	thiết kế
Prepare	/prɪˈpeər/	chuẩn bị
Arrange	/əˈreɪndʒ/	sắp xếp
Manage	/ˈmæn.ɪdʒ/	quản lý
Spend	/spend/	tiêu tiền
Save	/seɪv/	tiết kiệm
Borrow	/ˈbɒr.əʊ/	mượn
Owe	/əʊ/	nợ
Lend	/lend/	cho vay
Raise	/reɪz/	tăng
Decrease	/dɪˈkriːs/	giảm
Throw	/θrəʊ/	ném
Lack	/læk/	thiếu
Build	/bɪld/	xây
Face	/feɪs/	hướng về
Decorate	/ˈdek.ə.reɪt/	trang trí
Share	/ʃeər/	chia sẻ
Inform	/ɪnˈfɔːm/	báo tin
Develop	/dɪˈvel.əp/	phát triển
Invite	/ɪnˈvaɪt/	mời
Book	/bʊk/	đặt chỗ
Escape	/ɪˈskeɪp/	trốn khỏi
Experience	/ɪkˈspɪə.ri.əns/	trải nghiệm
Discover	/dɪˈskʌv.ər/	khám phá
Try	/traɪ/	thử
Recommend	/ˌrek.əˈmend/	đề xuất
Taste	/teɪst/	nếm thử
Hike	/haɪk/	đi bộ đường dài
Pray	/preɪ/	cầu nguyện
Party	/ˈpɑː.ti/	tiệc tùng
Welcome	/ˈwel.kəm/	hoan nghênh
Tidy	/ˈtaɪ.di/	dọn dẹp
Exchange	/ɪksˈtʃeɪndʒ/	trao đổi
Expect	/ɪkˈspekt/	mong đợi
Respect	/rɪˈspekt/	tôn trọng
Believe	/bɪˈliːv/	tin
Mean	/miːn/	có ý định
Surprise	/səˈpraɪz/	làm bất ngờ
Control	/kənˈtrəʊl/	điều khiển
Avoid	/əˈvɔɪd/	tránh
Persuade	/pəˈsweɪd/	thuyết phục
Approach	/əˈprəʊtʃ/	tiếp cận
Forecast	/ˈfɔː.kɑːst/	dự báo
Last	/lɑːst/	kéo dài
Boil	/bɔɪl/	luộc
Grill	/ɡrɪl/	nướng
Prepare	/prɪˈpeər/	chuẩn bị
Stir-fry	/ˈstɜː.fraɪ/	xào
Serve	/sɜːv/	phục vụ
Pour	/pɔːr/	rót
Stir	/stɜːr/	khuấy
Add	/æd/	thêm
Roast	/rəʊst/	nướng bỏ lò
Follow	/ˈfɒl.əʊ/	tuân theo
Stay	/steɪ/	giữ nguyên
Snack	/snæk/	ăn vặt
Breathe	/briːð/	thở
Mix	/mɪks/	trộn
Spoil	/spɔɪl/	bị hỏng
Plant	/plɑːnt/	trồng
Harvest	/ˈhɑː.vɪst/	thu hoạch
Pickle	/ˈpɪk.əl/	muối chua
Explore	/ɪkˈsplɔːr/	khám phá
Grow	/ɡrəʊ/	lớn lên
Protect	/prəˈtekt/	bảo vệ
Rely	/rɪˈlɑɪ/	dựa dẫm
Surround	/səˈraʊnd/	bao quanh
Sunbathe	/ˈsʌn.beɪð/	tắm nắng
Care	/keər/	quan tâm
Exercise	/ˈek.sə.saɪz/	tập thể dục
Damage	/ˈdæm.ɪdʒ/	phá hỏng
Prevent	/prɪˈvent/	phòng tránh
Remain	/rɪˈmeɪn/	giữ nguyên
Injure	/ˈɪn.dʒər/	gây thương tích
Bleed	/bliːd/	chảy máu
Hurt	/hɜːt/	làm bị đau
Suffer	/ˈsʌf.ər/	chịu đựng
Ease	/iːz/	xoa dịu
Consider	/kənˈsɪd.ər/	cân nhắc
Admit	/ədˈmɪt/	thừa nhận